1111111111111111111
1000C000E000000P001
1101001101100011111
1100101000010100001
1111111111111111111