1111111111111111111
10000000E000C00P001
1101001101100011111
1100101000010100001
1111111111111111111